###############
#......&......#
#....?...?..@.#
#.&...........#
#..?...?...?..#
#......&......#
#....?...?....#
#...........&.#
###############