###############
#......&.....?#
#....*...*..@.#
#.&...........#
#..*...*...*..#
#......&......#
#....*...*....#
#...........&.#
###############