...###
..##.#.####
.##..###..#
##........#
#....@..#.#
###..###..#
..#..#....#
.##.##.#.##
.#.......##
.#......##
.########