....###....
...#...#...
..#..&..#..
.#.......#.
#.........#
#.&..@..&.#
#.........#
.#.......#.
..#..&..#..
...#...#...
....###....
