######.....
#@....#...#
#...#..####
.#.##.....#
##......###
#......#...
#...##..#..
#..#.....#.
#..#.#....#
#..#.#....#
#..########
.##