###########
#.........#
#..##.##..#
#.#.....#.#
#.#.#.#.#.#
#....@....#
#.#.#.#.#.#
#.#.....#.#
#..##.##..#
#.........#
###########