###############
#?....***....?#
#.....*&*.....#
#...*.....*...#
#***..&&&..***#
#.............#
#......@......#
#......?......#
###############